12 12
A A A A A A A A A A A A
A S S A A O O A A S S A
A S A A A O O A A A S A
A A A O A O O A O A A A
A A A O A A A A O A A A
A O O O A W W A O O O A
A O O O A W W A O O O A
A A A O A A A A O A A A
A A A O A O O A O A A A
A S A A A O O A A A S A
A S S A A O O A A S S A
A A A A A A A A A A A A