6 6
W S A A A S
A A A A O S
A S A S A A
A A A A A S
A W A S A A
A A A O A A
