12 12
G G G G G G G G G G G G
G S S G G R R G G S S G
G S G G G R R G G G S G
G G G R G R R G R G G G
G G G R G G G G R G G G
G R R R G W W G R R R G
G R R R G W W G R R R G
G G G R G G G G R G G G
G G G R G R R G R G G G
G S G G G R R G G G S G
G S S G G R R G G S S G
G G G G G G G G G G G G
