CAMPAIGN
12 12
1 1 1 1 1 1 1 1 1 1 1 1
1 S S 1 1 2 2 1 1 S S 1
1 S 1 1 1 2 2 1 1 1 S 1
1 1 1 2 1 2 2 1 2 1 1 1
1 1 1 2 1 1 1 1 2 1 1 1
1 2 2 2 1 W W 1 2 2 2 1
1 2 2 2 1 W W 1 2 2 2 1
1 1 1 2 1 1 1 1 2 1 1 1
1 1 1 2 1 2 2 1 2 1 1 1
1 S 1 1 1 2 2 1 1 1 S 1
1 S S 1 1 2 2 1 1 S S 1
1 1 1 1 1 1 1 1 1 1 1 1
PLAYER 3 3
2 4
HARD 1 1
EASY 12 12