20 20
S S S S S S S S S S S S S S S S S S S S
S G G G G G G G G G G G G G G G G G G S
S G W W R W W G G R R G G R G G R R G S
S W G G R G R W W R R G G G R G G G G S
S R G R G G R G W W W G G G R G R G G S
S G R G G R G G G G W G R G G R R G G S
S G G G R G G G G G W G R G G R R G G S
S G R G R G R R R R R G R G G G G R G S
S G R G R G R G G G W W W G G G G R G S
S G G R G G R R G G R G W G R R G R G S
S G R G G G G R G R R G W W W R W R W S
S G G R G G G R G G G G G G R G G G W S
S G R G R R R R G G R G G R R G R G G S
S G G G G G G G G G R R R R G G G R G S
S G G G G G G R G G G G G G G G R G G S
S G G R R R G R G R G W G W W W W W W S
S R G G G R G G G W W R W G G R G G R S
S G G R G G G G W R G G R G R G R G R S
S G G G G G G G G G G R G G G G G G G S
S S S S S S S S S S S S S S S S S S S S