40 40
R R R R R R R R R R R R R R R R R R R R R R R R R R R R R R R R R R R R R R R R
R R R R R R R R R R R R R R R R R R R R R R R R R R R R R R R W W R R R R R R R
R R R R R R R R R R R G G R R R G G G R R R R R R R R G R R R W R R R R R R R G
R R R R W W R R R R R G W W R R R R R R R R R R R R R R G R R R R R R R R R R R
R R R R R W R R R R R R W R R R R R R R R R R R R R R R R R R R R R R R R R R R
R R R R W W G G G R R R W W R R R R R R R G G G R R R G G G R W R R R W R R R R
R R R R R R R R R R R R R R R R R R R R R R R R R R R R R R R R R R R W R R R R
R R R R R R R R R R R R R R R R R R R R R R G R R R R R R R R R R R G R R R R R
R R R R R G G R R R R R R R R R R R R R R R G R R R R R R R R R R R G G R R R R
R R R R R G R R R R R W W R R R R R R R R R G R R R R R R R R R R R R G R R R R
R R R R R R R R R R R W R R G R R G G G G G G G R R R R R R R R R R R G R R R R
R R R R R R R R R R W W R R G W W W R R R R R R R R R R R R R R R R R R R R R R
R R R R R G G R R R R R R R G R R R R R R R R R R R R R R R R R R R R R R R R R
R R R R R R R R G G G G R R R R R R R R R R R R R R R R R R R R R R R R R R R R
R R R R R R R R G R R R R R R R R R R R R R R R R G G G R R R R R R R R R R R R
G G R R G G G R R R R R R R R R R R R R R R R R R R R G R R R R R R R R R R R R
G G G R R R R R W W W R R R R R R R R R R R R R R R R R R R R W W R R G R R R R
G G G R R R R R R R R R R R R R R R R W W R R R R R R R R R R R R R R G R R R R
R R R R R R R R R R R R R R R R R R R R R R R R R R R R R R R R R R R G R R R R
R R R R R R R R R R R R R R R R R R R R R R R R R R R R R G G G R R R G R R R R
R R R R R R R R R R R R R R R R R W R R R R R R R R R R R G R R R R R R R R R R
R R R R R R R R R R R R R R R R W R R R R R R R R R R R R G R R R R R R R R R R
R R R R R R R R R R R W W W R W W R R R R R R R R R R R R G R W W W R R R R R R
R R R R R R R R R R W R R R R R R R R R R R R R R R R R R G R R R R R R R R R R
R R R R R R R R R W R R R R R R R R R R R R R R R W R R R G R R R R R R R R R R
R R R R R W R R W R R R R R R R R R R R R R R R R W R R R R R R R R R R R R R R
R R R R W G R R R R R R R R R R R R R R R R R R R W R R R G R R R R R R R R R R
R R R R R G G R R R R R R R R R R R R R R R R R R R R R R G R R W W W R R R R R
R R W R W G G G R R R R R R R R R R R R W R R R R G G G R R R R W R W R R R R R
R R W R R G G G G W R R R R R R R R R R W W R R R R R R R R R R W W W R R R R R
R R R R R G G G R R R R R R W R R R R R W R R R R G G R R R R R R R R R R R R R
R R R R R G G R R R R R R R W R R R R R R R R R R R G R R R R R R R R R R R R R
R R R R R G R R R R R R R R R R R R R R G G G R R R R R R G G G R R R R R R R R
R R R R R R R R R R R R R R R R R R R R R R R R R R R R R R R R R R R R R R R R
R R R R R R R R R R R R W W W R R R R R R R R R R R R R R R R R G R R R R R R R
W W W R R R R R R R R R W G W R R W W W W R R R R W W R R R R R G R R R R R R R
R R R R R R R R R R R R R W R R R W G G G R G R R R R W R R R R G R R R R R R R
R R R R R R R R R R R R R R R R R W W W W R G R R R R R R R R R R R R R R R R R
R R R R R W W W R R R R R R R R R W R R W R R R G G G R R R R R R R R R R R R R
R R R R R R R R R R R R R R R R R W W W W R R R R R R R R R R R R R R R R R R R