20 20
S S S S S S S S S R R S S S S S S S S S
S G G G G G R G R R R G G R R G G G G S
S G R R G R R G G R R R G R R G R G G S
S G R R G G G G G G G G G G G G R G G S
S G G S S G R G G R R G G R R G R G G S
S G G G G G G W W G G W W G G G G R G S
S G R R G G G W W W G W W W W G G R G S
S G G G G S R R R W W W W W G G G R G S
S G R G G W W W R R W W W W G G G R R S
S G R R G W W W W R R W W W W G R R G S
S G G G G W W W W W R R R R R G R W G S
S G G G W W W W W R R W W W W G G R G S
S G R R G W W W W R W W W W W G G R G S
S G G G G W W W R R W W W W G G G G G S
S G R G G G G W R W W W W G G G R G G S
S G R R R W G G G G W W G G G R R R G S
S G G R R G G G G G G G G G G R G G G S
S G G G G R R G G S S S G R G G R G G S
S G G G G G G G R G R G G G G G G G G S
S S S S S S S S S S S S S S S S S S S S