32 31
2 2 2 2 2 2 2 2 2 2 2 2 2 2 2 2 2 2 2 2 2 2 2 2 2 2 2 2 2 2 2 2
2 2 2 2 S S S S S S S S S 2 2 2 2 2 2 2 S S S S 2 2 2 2 2 2 2 2
2 2 2 2 S S S S S S S S S 2 2 2 2 2 2 S S S S S S 2 2 2 2 2 2 2
2 2 2 2 2 2 2 S S S 2 2 2 2 2 2 2 2 2 S S 2 2 S S 2 2 2 2 2 2 2
2 2 2 2 2 2 2 S S S 2 2 2 2 2 2 2 2 S S 2 2 2 2 S S 2 2 2 2 2 2
2 2 2 2 2 2 2 S S S 2 2 2 2 2 2 2 S S S 2 S S 2 S S S 2 2 2 2 2
2 2 2 2 2 2 2 S S S 2 2 2 2 2 2 2 S S S 2 S S 2 S S S 2 2 2 2 2
2 2 2 2 2 2 2 S S S 2 2 2 2 2 2 S S S 2 2 2 2 2 2 S S S 2 2 2 2
2 2 2 2 2 2 2 S S S 2 2 2 2 2 2 S S S 2 2 2 2 2 2 S S S 2 2 2 2
2 2 2 2 2 2 2 2 2 2 2 2 2 2 2 2 2 2 2 2 2 2 2 2 2 2 2 2 2 2 2 2
2 S S 2 2 2 2 2 S S 2 2 S S 2 2 2 S S 2 2 S S S S S S S S S S 2
2 S S S 2 2 2 2 S S 2 2 S S 2 2 S S 2 2 2 S S S S S S S S S S 2
2 S S S S 2 2 2 S S 2 2 S S 2 S S 2 2 2 2 2 2 2 2 2 S S S S S 2
2 S S 2 S S 2 2 S S 2 2 S S S S 2 2 2 2 2 2 2 2 2 S S S S S 2 2
2 S S 2 2 S S 2 S S 2 2 S S S S 2 2 2 2 2 2 2 2 S S S S S 2 2 2
2 S S 2 2 2 S S S S 2 2 S S 2 S S 2 2 2 2 2 2 S S S S S 2 2 2 2
2 S S 2 2 2 2 S S S 2 2 S S 2 2 S S 2 2 2 2 S S S S S S S S S 2
2 S S 2 2 2 2 2 S S 2 2 S S 2 2 2 S S 2 2 S S S S S S S S S S 2
2 2 2 2 2 2 2 2 2 2 2 2 2 2 2 2 2 2 2 2 2 2 2 2 2 2 2 2 2 2 2 2
2 S S S S S S 2 2 S S S S S S 2 2 S S S S S S 2 2 S S 1 1 S S 2
2 S S S S S S 2 2 S S S S S S 2 2 S S S S S S 2 2 S S 1 1 S S 2
2 1 1 2 2 S S 2 2 S S 2 2 S S 2 2 1 1 2 2 S S 2 2 S S 2 2 S S 2
2 1 1 2 2 S S 2 2 S S 2 2 S S 2 2 1 1 2 2 S S 2 2 S S 2 2 S S 2
2 S S S S S S 2 2 S S 1 1 S S 2 2 1 1 1 1 S S 2 2 S S S S S S 2
2 S S S S S S 2 2 S S 1 1 S S 2 2 1 1 1 1 S S 2 2 S S S S S S 2
2 S S 2 2 1 1 2 2 S S 2 2 S S 2 2 1 1 2 2 S S 2 2 1 1 2 2 S S 2
2 S S 2 2 1 1 2 2 S S 2 2 S S 2 2 1 1 2 2 S S 2 2 1 1 2 2 S S 2
2 S S S S S S 2 2 S S S S S S 2 2 1 1 1 1 S S 2 2 1 1 1 1 S S 2
2 S S S S S S 2 2 S S S S S S 2 2 1 1 1 1 S S 2 2 1 1 1 1 S S 2
2 2 2 2 2 2 2 2 2 2 2 2 2 2 2 2 2 2 2 2 2 2 2 2 2 2 2 2 2 2 2 2
2 2 2 2 2 2 2 2 2 2 2 2 2 2 2 2 2 2 2 2 2 2 2 2 2 2 2 2 2 2 2 2