32 31
G G G G G G G G G G G G G G G G G G G G G G G G G G G G G G G G
G G G G S S S S S S S S S G G G G G G G S S S S G G G G G G G G
G G G G S S S S S S S S S G G G G G G S S S S S S G G G G G G G
G G G G G G G S S S G G G G G G G G G S S G G S S G G G G G G G
G G G G G G G S S S G G G G G G G G S S G G G G S S G G G G G G
G G G G G G G S S S G G G G G G G S S S G S S G S S S G G G G G
G G G G G G G S S S G G G G G G G S S S G S S G S S S G G G G G
G G G G G G G S S S G G G G G G S S S G G G G G G S S S G G G G
G G G G G G G S S S G G G G G G S S S G G G G G G S S S G G G G
G G G G G G G G G G G G G G G G G G G G G G G G G G G G G G G G
G S S G G G G G S S G G S S G G G S S G G S S S S S S S S S S G
G S S S G G G G S S G G S S G G S S G G G S S S S S S S S S S G
G S S S S G G G S S G G S S G S S G G G G G G G G G S S S S S G
G S S G S S G G S S G G S S S S G G G G G G G G G S S S S S G G
G S S G G S S G S S G G S S S S G G G G G G G G S S S S S G G G
G S S G G G S S S S G G S S G S S G G G G G G S S S S S G G G G
G S S G G G G S S S G G S S G G S S G G G G S S S S S S S S S G
G S S G G G G G S S G G S S G G G S S G G S S S S S S S S S S G
G G G G G G G G G G G G G G G G G G G G G G G G G G G G G G G G
G S S S S S S G G S S S S S S G G S S S S S S G G S S R R S S G
G S S S S S S G G S S S S S S G G S S S S S S G G S S R R S S G
G R R G G S S G G S S G G S S G G R R G G S S G G S S G G S S G
G R R G G S S G G S S G G S S G G R R G G S S G G S S G G S S G
G S S S S S S G G S S R R S S G G R R R R S S G G S S S S S S G
G S S S S S S G G S S R R S S G G R R R R S S G G S S S S S S G
G S S G G R R G G S S G G S S G G R R G G S S G G R R G G S S G
G S S G G R R G G S S G G S S G G R R G G S S G G R R G G S S G
G S S S S S S G G S S S S S S G G R R R R S S G G R R R R S S G
G S S S S S S G G S S S S S S G G R R R R S S G G R R R R S S G
G G G G G G G G G G G G G G G G G G G G G G G G G G G G G G G G
G G G G G G G G G G G G G G G G G G G G G G G G G G G G G G G G