23 19
G G G G G G G G G G G G G G G G G G G G G G G
G S S S G S S S S G S S S G S S W G S S S G R
G S S S G S S S S G S S S G S S W G G G G G R
G S S S G S S S S G S S S G S S W G S S S G R
G G G G G G G G G G G G G G G G G G G G G G G
G S G S G R R R R G S S S G S S W G S S S G S
G S G S G W W W W G S S S G S S W G G S S G S
G S G S G R R R R G S S S G S S W G S S S G S
G G G G G G G G G G G G G G G G G G G G G G G
G S G S G S S S S S S S S G S G S G S S S G R
G S S S G S W W W W S S S G S G S G S S S G R
G S S S G S S S S S S S S G S G S G S S S G R
G G G G G G G G G G G G G G G G G G G G G G G
G S S S G R R R R G R R R G S S S G S S G S G
G S S S G R G G G G G G R G S S S G S S G G G
G S S G G G G R R R R G G G G G G G G G S S G
G S S S G R G G G G G G R G S G W G S G S S G
G S S S G R R R R G R R R G S G W G S G G G G
G G G G G G G G G G G G G G G G G G G G G G G