20 22
S S S S S S S S S S S S S S S S S S S S
S G G S G G G G G S S S S S S S S S S S
S S G S G S G S G S S S S S S S S S S S
S S G G G S S S G S S S S S S S S S S S
S G G S S S G G G S S S S S S S S S S S
S S G S S G G G S S S S S S S S S S S S
S G G G G G S G S S S S S S S S S S S S
S S G S S S S G S S S S S S S S S S S S
S S G S S S G G G S S S S S S S S S S S
S G G G G G G G G G S S S S S S S S S S
S S S S S S S S G G S S S S S S S S S S
S S G G G S G G G S S S S S S S S S S S
S G G S S S S S S S S S S S S S S S S S
S S G G S S S S S S S S S S S S S S S S
S G S G G G G G S S S S S S S S S S S S
S G G G S S G G S S S S S S S S S S S S
S S S G G G G S S S S S S S S S S G S S
S G S S G G S S S S S S S S S S S G S S
S G G S G G G S S S S S S S S S S G G S
S G S G S S G S S S S S S S S S S S G S
S G G G G G G S S S G S S G S S R S G S
S S S S S S S S S S S S S S S S S S S S