CAMPAIGN
20 22
S S S S S S S S S S S S S S S S S S S S
S G G S G G G G G S G G G S S S G G G S
S S G S G S G S G S G S G G S G G S G S
S S G G G S S S G S S S S G S G S S G S
S G G S S S G G G S G G S G S G G G S S
S S G S S G G G S S G G G G S S S G S S
S G G G G G S G G G G G S S S S G G S S
S S G S S S S G S S S G G G G S G S S S
S S G S S S G G G S S G S S G G G S S S
S G G G G G G G G G S G S G G S S S S S
S S S S S S S S G G S G G G G G G G G S
S S G G G S G G G S S S S S G S G S S S
S G G S G G G S G G S G G G G S G S S S
S S G G S S S S S G S G S S S G G G S S
S G S G G G G G S G S G S G G G S G G S
S G G G S S G G S S S G S S G S S S G S
S S S G G G G S G G G G S G G G S G G S
S G S S G G S S G S S G S S S S S G S S
S G G S G G G S G S S S S S G G S G G S
S G S G S S G G G G G G G G G S S S G S
S G G G G G G S S S G S S G S S R S G S
S S S S S S S S S S S S S S S S S S S S
PLAYER 2 2
1 1
EASY 20 22