9 40
S G G G S G G G S
S G G G S G G G S
S G G G G G G G S
S G G G R G G G S
S G G G G G G G S
S G G G S G G G S
S G G G S G G G S
S G G G G G G G S
S G G G R G G G S
S G G G G G G G S
S G G G S G G G S
S G G G S G G G S
S G G G G G G G S
S G G G R G G G S
S G G G G G G G S
S G G G S G G G S
S G G G S G G G S
S G G G G G G G S
S G G G R G G G S
S G G G G G G G S
S G G G S G G G S
S G G G S G G G S
S G G G G G G G S
S G G G R G G G S
S G G G G G G G S
S G G G S G G G S
S G G G S G G G S
S G G G G G G G S
S G G G R G G G S
S G G G G G G G S
S G G G S G G G S
S G G G S G G G S
S G G G G G G G S
S G G G R G G G S
S G G G G G G G S
S G G G S G G G S
S G G G S G G G S
S G G G G G G G S
S G G G R G G G S
S G G G G G G G S