CAMPAIGN
32 17
S S S S S S S S S S S S S S S S S S S S S S S S S S S S S S S S
S G G G G G G G G G G G G G G G G G G G G G G G G G G G G G G S
S G S S S W S S S S W S S S S S S S S S S W S S S S W S S S G S
S G S G G G G G G G G G G G G R S G G G G G G G G G G G G S G S
S G S G S S S W S S S S S S G S R G S S S S S S W S S S G S G S
S G S G S G G G G G G G G S G R S G S G G G G G G G G S G S G S
S G S G S G S S W S S S G S G S R G S G S S S W S S G S G S G S
S G S G S G S G G G G S G S G R S G S G S G G G G S G S G S G S
S G S G S G S G S S G W G S G S R G S G W G S S G S G S G S G S
S G S G S G S G G S G S G S G R S G S G S G S G G S G S G S G S
S G W G W G S S S S G S G S G S R G S G S G S S S S G W G W G S
S G S G S G G G G G G S G S G R S G S G S G G G G G G S G S G S
S G S G S S S S S W S S G S G S R G S G S S W S S S S S G S G S
S G S G G G G G G G G G G S G R S G S G G G G G G G G G G S G S
S G S S W S S S S S S W S S G S R G S S W S S S S S S W S S G S
S G G G G G G G G G G G G G G R S G G G G G G G G G G G G G G S
S S S S S S S S S S S S S S S S S S S S S S S S S S S S S S S S
PLAYER 2 2
1 1
EASY 31 16